TEXTURE:
BBBBBBBBBBBMS+BBBBBBBBBBBBBBBBBBBBBBBBBBBBBBBBBBBBBBBBBBBBBBBBBB
+..............................................................+
+..............................................................+
+..............................................................+
+..............................................................+
+..............................................................+
+..............................................................+
+..............................................................+
+..............................................................+
+..............................................................+
+..............................................................+
+++++++++++++++++++++++++++++++WW+++++++++++++++++++++++++++++++
+++++++++++++++++++++++++++++++WW+++++++++++++++++++++++++++++++
+++++++++++++++++++++++++++++++WW+++++++++++++++++++++++++++++++
+++++++++++++++++++++++++++++++WW+++++++++++++++++++++++++++++++
+++++++++++++++++++++++++++++++WW+++++++++++++++++++++++++++++++
+++++++++++++++++++++++++++++++WW+++++++++++++++++++++++++++++++
+++++++++++++++++++++++++++++++WW+++++++++++++++++++++++++++++++
+++++++++++++++++++++++++++++++WW+++++++++++++++++++++++++++++++
+..............................................................+
+..............................................................+
+..............................................................+
+..............................................................+
+..............................................................+
+..............................................................+
+..............................................................+
+..............................................................+
+..............................................................+
+..............................................................+
++++++++++++++++++++++++++++++++++++++++++++++++++++++++++++++++
HEIGHT:
9999999999999999999999999999999999999999999999999999999999999999
9000000000000000000000000000000000000000000000000000000000000009
9000000000000000000000000000000000000000000000000000000000000009
9000000000000000000000000000000000000000000000000000000000000009
9000000000000000000000000000000000000000000000000000000000000009
9000000000000000000000000000000123456780000000000000000000000009
9000000000000000000000000000000000000000000000000000000000000009
9000000000000000000000000000000000000000000000000000000000000009
9000000000000000000000000000000000000000000000000000000000000009
9000000000000000000000000000000000000000000000000000000000000009
9000000000000000000000000000000000000000000000000000000000000009
9999999999999999999999999999999999999999999999999999999999999999
0000111222333444555666777888999999998887776665554443332221110000
0000111222333444555666777888999999998887776665554443332221110000
0000111222333444555666777888999999998887776665554443332221110000
0000111222333444555666777888999999998887776665554443332221110000
0000111222333444555666777888999999998887776665554443332221110000
0000111222333444555666777888999999998887776665554443332221110000
9999999999999999999999999999999999999999999999999999999999999999
9000000000000000000000000000000000000000000000000000000000000009
9000000000000000000000000000000000000000000000000000000000000009
9000000000000000000000000000000000000000000000000000000000000009
9000000000000000000000000000000000000000000000000000000000000009
9000000000000000000000000000000000000000000000000000000000000009
9000000000000000000000000000000000000000000000000000000000000009
9000000000000000000000000000000000000000000000000000000000000009
9000000000000000000000000000000000000000000000000000000000000009
9000000000000000000000000000000000000000000000000000000000000009
9000000000000000000000000000000000000000000000000000000000000009
9999999999999999999999999999999999999999999999999999999999999999
OBJ:
J|2|2|0
T|1
