++++++++++++++++++++++++++++++++++++++++++++++++++++++++++++++++
+                                                              +
+                                                              +
+       J                                                      +
+                                                              +
+                                                              +
+                                                              +
+                                                              +
+                                                              +
+                                                              +
+                                                              +
++++++++++++++++++++++++++++++++++++++++++++++++++++++++++++++++
