# **************************************************************************** #
#                                                                              #
#                                                         :::      ::::::::    #
#    map3                                               :+:      :+:    :+:    #
#                                                     +:+ +:+         +:+      #
#    By: alerandy <alerandy@student.42.fr>          +#+  +:+       +#+         #
#                                                 +#+#+#+#+#+   +#+            #
#    Created: 2018/02/22 17:42:55 by alerandy          #+#    #+#              #
#    Updated: 2018/03/06 15:56:21 by alerandy         ###   ########.fr        #
#                                                                              #
# **************************************************************************** #

TEXTURE:
++++++++++++++++++++++++++++++++++++++++++++++++++++++++++++++++
+00000000000000000000000000000000000000000000000000000000000000+
+00000000000000000000000000000000000000000000000000000000000000+
+00000000000000000000000000000000000000000000000000000000000000+
+++++++++++++++++++++++++++++++++++++0000+++++++++++++++++++++++
++++++++++++++++++++++++++++++++++++0000++++++++++++++++++++++++
+++++++++++++++++++++++++++++++++++0000+++++++++++++++++++++++++
+++++++++++++++++++++++++++++++++++0000000000000000000000000000+
+++++++++++++++++++++++++++++++++++0000000000000000000000000000+
+++++++++++++++++++++++++++++++++++0000000000000000000000000000+
++++++++++++++++++++++++++++++++++++++++++++++++++++++++++0000++
++++++++++++++++++++++++++++++++++++++++++++++++++++++++++0000++
+00000000000000000000000000000000000000000000000000000000000000+
+00000000000000000000000000000000000000000000000000000000000000+
+00000000000000000000000000000000000000000000000000000000000000+
+00000000000000000000000000000000000000000000000000000000000000+
++++++++++++++++++++++++++++++++++++++++++++++++++++++++++++++++
HEIGHT:
9999999999999999999999999999999999999999999999999999999999999999
9000000000000000000000000000000000000000000000000000000000000009
9000000000000000000000000000000000000000000000000000000000000009
9000000000000000000000000000000000000000000000000000000000000009
9999999999999999999999999999999999999000099999999999999999999999
9999999999999999999999999999999999990000999999999999999999999999
9999999999999999999999999999999999900009999999999999999999999999
9999999999999999999999999999999999900000000000000000000000000009
9999999999999999999999999999999999900000000000000000000000000009
9999999999999999999999999999999999900000000000000000000000000009
9999999999999999999999999999999999999999999999999999999999000099
9999999999999999999999999999999999999999999999999999999999000099
9000000000000000000000000000000000000000000000000000000000000009
9000000000000000000000000000000000000000000000000000000000000009
9000000000000000000000000000000000000000000000000000000000000009
9000000000000000000000000000000000000000000000000000000000000009
9999999999999999999999999999999999999999999999999999999999999999
OBJ:
J|2|2|0
