TEXTURE:
++++++++++++++++++++++++++++++++++++++++++++++++++++++++++++++++++++++
+....................................................................+
+....................................................................+
+....................................................................+
+....................................................................+
+....................................................................+
+....................................................................+
+....................................................................+
+....................................................................+
+....................................................................+
+....................................................................+
+....................................................................+
+....................................................................+
+....................................................................+
+....................................................................+
+....................................................................+
+....................................................................+
+....................................................................+
+....................................................................+
+....................................................................+
+....................................................................+
+....................................................................+
+....................................................................+
+....................................................................+
+....................................................................+
+....................................................................+
+....................................................................+
+....................................................................+
+....................................................................+
+....................................................................+
+....................................................................+
+....................................................................+
+....................................................................+
+....................................................................+
+....................................................................+
+....................................................................+
+....................................................................+
+....................................................................+
+....................................................................+
+....................................................................+
+....................................................................+
+....................................................................+
+....................................................................+
+....................................................................+
+....................................................................+
+....................................................................+
+....................................................................+
+....................................................................+
+....................................................................+
+....................................................................+
+....................................................................+
+....................................................................+
+....................................................................+
+....................................................................+
+....................................................................+
+....................................................................+
+....................................................................+
+....................................................................+
+....................................................................+
+....................................................................+
+....................................................................+
+....................................................................+
+....................................................................+
+....................................................................+
+....................................................................+
+....................................................................+
+....................................................................+
+....................................................................+
+....................................................................+
++++++++++++++++++++++++++++++++++++++++++++++++++++++++++++++++++++++
HEIGHT:
9999999999999999999999999999999999999999999999999999999999999999999999
9....................................................................9
9....................................................................9
9....................................................................9
9....................................................................9
9....................................................................9
9...............................................9....................9
9..............................................9.....................9
9.............................................9......................9
9............................................9.......................9
9...........................................9........................9
9..........................................9.........................9
9.........................................9..........................9
9........................................9...........................9
9.......................................9............................9
9......................................9.............................9
9.....................................9..............................9
9....................................9...............................9
9...................................9................................9
9..................................9.................................9
9.................................9..................................9
9................................9...................................9
9...............................9....................................9
9..............................9.....................................9
9.............................9......................................9
9............................9.......................................9
9...........................9........................................9
9..........................9.........................................9
9.........................9..........................................9
9........................9...........................................9
9.......................9............................................9
9......................9.............................................9
9.....................9..............................................9
9....................9...............................................9
9...................9................................................9
9..................9.................................................9
9.................9..................................................9
9................9...................................................9
9...............9....................................................9
9....................................................................9
9....................................................................9
9....................................................................9
9....................................................................9
9....................................................................9
9....................................................................9
9....................................................................9
9....................................................................9
9....................................................................9
9....................................................................9
9....................................................................9
9....................................................................9
9....................................................................9
9....................................................................9
9....................................................................9
9....................................................................9
9....................................................................9
9....................................................................9
9....................................................................9
9....................................................................9
9....................................................................9
9....................................................................9
9....................................................................9
9....................................................................9
9....................................................................9
9....................................................................9
9....................................................................9
9....................................................................9
9....................................................................9
9....................................................................9
9999999999999999999999999999999999999999999999999999999999999999999999
OBJ:
...
...
..J
